TILEMAP
48 26 							-- Size of tile map in tiles
8 8 							-- Tile size & block size
images/blocks/paret1_64x8.png 	-- Tilesheet
8 1							-- Number of tiles in tilesheet
123232323232323232323232323232323232323232323231
1               5              5               1
1               6              6               1
1               6              6               1
1               6              6               1
1               6              6               1
1               7              7               1
1               8              8               1
1               .   .   .   .                  1
1                                              1
1                                              1
1                                              1
1                                              1
1                                              1
1                                              1
1        4                           4         1
1                                              1
1                                              1
1                                              1
1                                              1
1                                              1
1                                              1
1                                              1
1                                              1
1                                              1
123232323232323232323232323232323232323232323231


