TILEMAP
48 26 							-- Size of tile map in tiles
8 8 							-- Tile size & block size
images/blocks/paret2_64x8.png 	-- Tilesheet
8 1							-- Number of tiles in tilesheet
123232323232323232323232323232323232323232323231
1                                              1
1                                              1
1                                              1
1                                              1
1                                              1
1                                              1
1                                              1
1                                              1
1       56666666666666666666666666666666678    1
1                                              1
1                                              1
1                                              1
1                                              1
1                                              1
1                                              1
1                                              1
1       5678.  6666666666678.  566666666678    1
1                          4                   1
1                                              1
1                                              1
1                                              1
1                                              1
1                                              1
1                                              1
123232323232323232323232323232323232323232323231
Escaleras
23
43
21
43
19
43
17
43
13
43
11
43
9
43
Fin